12,12,999999,1
18,18,18,18,18,18,18,18,18,18,18,18
18,02,02,02,02,02,02,02,02,02,02,18
18,02,02,02,02,02,04,02,02,02,02,18
18,02,02,02,02,02,01,02,02,02,02,18
18,02,02,02,02,02,01,02,02,02,02,18
18,02,02,02,00,02,01,02,02,02,02,18
18,02,02,02,02,02,01,02,02,02,02,18
18,02,02,02,02,02,01,02,02,02,02,18
18,02,02,02,02,02,02,02,02,02,02,18
18,02,02,02,02,02,02,02,02,02,02,18
18,02,02,02,02,02,02,02,02,02,08,18
18,18,18,18,18,18,18,18,18,18,18,18


14,14,9999,2
18,18,18,18,18,18,18,18,18,18,18,18,18,18
18,01,01,01,02,18,01,01,31,01,01,02,02,18
18,01,01,01,01,18,00,02,18,01,02,01,02,18
18,02,07,01,02,18,02,02,18,01,29,01,01,18
18,02,02,01,01,33,01,01,18,02,02,01,02,18
18,18,18,18,18,18,02,02,18,18,18,18,18,18
18,02,02,02,05,02,01,02,02,02,02,01,01,18
18,01,01,02,02,01,02,02,01,05,02,01,01,18
18,18,18,18,18,18,01,01,18,37,18,18,18,18
18,01,01,01,02,18,02,01,18,02,02,01,01,18
18,02,38,02,02,28,01,35,18,01,02,01,02,18
18,02,01,01,02,18,01,02,18,01,01,35,02,18
18,01,02,02,02,18,01,02,18,02,02,02,02,18
18,18,18,18,18,18,18,18,18,18,18,18,18,18

24,24,9999,9
18,18,18,18,18,18,18,18,18,18,18,18,18,18,18,18,18,18,18,18,18,18,18,18
18,02,01,01,01,02,02,18,01,02,02,01,01,01,02,01,18,02,02,01,01,01,01,18
18,02,01,38,01,01,01,18,02,01,02,02,01,02,02,01,18,02,02,02,02,02,02,18
18,02,02,02,02,01,02,18,01,00,01,02,02,01,01,02,18,01,01,02,01,02,02,18
18,02,01,02,02,02,02,18,01,01,01,01,01,02,02,32,27,01,02,02,02,02,01,18
18,02,02,01,05,02,02,18,01,02,02,01,01,02,01,01,18,01,02,01,01,01,02,18
18,01,02,02,02,01,02,18,02,01,01,01,01,02,02,02,18,01,01,01,02,01,02,18
18,33,18,18,18,18,18,18,02,02,01,01,01,02,01,02,18,18,18,18,18,18,18,18
18,01,01,01,02,02,01,02,01,02,01,02,02,02,01,02,02,05,01,02,05,02,01,18
18,01,01,01,01,02,02,01,02,02,01,02,02,02,01,02,01,02,02,02,02,01,01,18
18,02,01,02,01,02,02,02,01,01,01,01,01,05,02,01,01,02,01,01,01,02,02,18
18,02,01,01,01,01,02,02,01,01,01,02,01,01,02,02,02,01,01,02,01,01,02,18
18,02,02,02,02,01,01,01,01,01,01,02,01,02,02,02,02,02,01,02,02,02,02,18
18,02,01,02,02,01,02,01,02,02,01,01,05,01,02,02,32,02,02,02,01,02,02,18
18,02,02,02,01,02,02,02,01,01,01,02,01,01,01,01,05,02,01,02,01,02,02,18
18,01,01,01,01,01,02,02,01,01,01,02,01,01,02,01,01,02,02,01,01,01,02,18
18,18,18,18,18,36,18,18,01,01,01,01,02,01,01,02,18,18,30,18,18,18,18,18
18,01,02,02,02,01,02,18,02,01,02,01,01,01,01,01,18,01,02,01,02,01,01,18
18,02,02,01,01,01,01,18,01,01,01,02,01,02,02,01,18,01,02,01,02,07,01,18
18,02,01,01,32,02,02,18,02,01,02,02,01,02,02,02,18,01,01,01,05,01,01,18
18,01,01,02,01,01,02,18,01,02,01,01,05,01,02,01,18,01,02,02,02,01,01,18
18,01,02,01,01,01,01,18,02,01,05,02,02,02,01,01,18,01,01,35,02,02,02,18
18,02,01,01,02,02,01,18,02,02,01,01,02,02,01,01,18,01,01,01,02,01,02,18
18,18,18,18,18,18,18,18,18,18,18,18,18,18,18,18,18,18,18,18,18,18,18,18


