18,18,18,18,18,18,18,18,18,18,18,18
18,02,02,02,02,02,02,02,02,02,02,18
18,02,02,02,02,02,04,02,02,02,02,18
18,02,02,02,02,02,01,02,02,02,02,18
18,02,02,02,02,02,01,02,02,02,02,18
18,02,02,02,00,02,01,02,02,02,02,18
18,02,02,02,02,02,01,02,02,02,02,18
18,02,02,02,02,02,01,02,02,02,02,18
18,02,02,02,02,02,02,02,02,02,02,18
18,02,02,02,02,02,02,02,02,02,02,18
18,02,02,02,02,02,02,02,02,02,08,18
18,18,18,18,18,18,18,18,18,18,18,18
